56 56 56 56 56 56 56 56 56 56 56 56 56 56 56 56 56 56 56 56 56 56 56 56 56 56 56 56 56 56 56 56 56 56 56 56 56 56 56 56 56 56
56 56 56 56 56 56 56 56 56 56 56 56 56 56 56 56 56 56 56 56 56 56 56 56 56 56 56 56 56 56 56 56 56 56 56 56 56 56 56 56 56 56
56 56 55 55 55 55 55 55 55 55 55 55 55 55 56 55 55 55 55 55 55 55 55 55 55 55 55 55 56 55 55 55 55 55 55 55 55 55 55 55 56 56
56 56 55 55 55 55 55 55 55 55 55 55 55 55 56 55 55 55 55 55 55 55 55 55 55 55 55 55 56 55 55 55 55 55 55 55 55 55 55 55 56 56
56 56 55 55 55 55 55 55 55 55 55 55 55 55 56 55 55 55 55 55 55 55 55 55 55 55 55 55 55 55 55 55 55 55 55 55 55 55 55 55 56 56
56 56 55 55 55 57 55 55 55 55 55 55 55 55 56 55 55 55 55 55 55 55 55 55 55 55 55 55 55 55 55 55 55 55 55 55 55 55 55 55 56 56
56 56 55 55 55 55 55 55 57 55 55 55 55 55 56 55 55 55 55 55 55 55 55 55 55 55 55 55 55 55 55 55 55 55 55 55 55 55 55 55 56 56
56 56 55 55 55 55 55 55 55 55 55 55 55 55 56 55 55 55 55 55 55 55 55 55 55 55 55 55 55 55 55 55 55 57 55 55 55 55 55 55 56 56
56 56 55 55 55 55 55 55 55 55 55 55 55 55 56 56 56 56 55 55 55 55 55 55 56 56 56 56 56 55 55 55 55 55 55 55 55 55 55 55 56 56
56 56 55 55 55 55 55 55 55 55 55 55 55 55 56 55 55 55 55 55 55 55 55 55 55 55 55 55 56 55 55 55 55 55 55 55 55 55 55 55 56 56
56 56 55 55 55 55 55 55 55 55 55 55 55 55 55 55 55 55 55 55 55 55 55 55 55 55 55 55 56 55 55 55 55 55 55 55 55 55 55 55 56 56
56 56 55 55 55 55 55 55 55 55 57 55 55 55 55 55 55 55 55 55 55 55 55 55 55 55 55 55 56 55 55 55 55 55 55 55 55 55 55 55 56 56
56 56 55 55 55 55 55 55 55 55 55 55 55 55 55 55 55 55 55 55 55 55 55 55 55 55 55 55 56 55 55 55 55 55 55 55 55 55 55 55 56 56
56 56 55 55 55 55 55 55 55 55 55 55 55 55 55 55 55 55 55 55 55 55 57 55 55 55 55 55 56 55 55 55 55 55 55 55 55 55 55 55 56 56
56 56 55 55 55 55 55 55 55 55 55 55 55 55 56 55 55 55 55 55 55 55 55 55 55 55 55 55 56 55 55 55 55 55 55 55 55 55 55 55 56 56
56 56 55 55 55 55 55 55 55 55 55 55 55 55 56 55 55 55 55 55 55 55 55 55 55 55 55 55 56 55 55 55 55 55 55 55 55 55 55 55 56 56
56 56 55 55 55 55 55 55 55 55 55 55 55 55 56 55 55 55 55 55 55 55 55 55 55 55 55 55 56 55 55 55 55 55 55 57 55 55 55 55 56 56
56 56 55 55 55 55 55 55 55 55 55 55 55 55 56 55 55 55 55 55 55 55 55 55 55 55 55 55 56 55 55 55 55 55 55 55 55 55 55 55 56 56
56 56 55 55 55 55 55 55 55 55 55 55 55 55 56 56 56 56 56 56 55 55 55 55 55 56 56 56 56 55 55 55 55 55 55 55 55 55 55 55 56 56
56 56 55 55 55 55 55 55 55 55 55 55 55 55 56 55 55 55 55 55 55 55 55 55 55 55 55 55 56 55 55 55 55 55 55 55 55 55 55 55 56 56
56 56 55 55 55 55 55 55 55 55 55 55 55 55 56 55 55 55 55 55 55 55 55 55 55 55 55 55 56 55 55 55 55 55 55 55 55 55 55 55 56 56
56 56 55 55 55 55 55 55 55 55 55 55 55 55 56 55 55 55 55 55 55 55 55 55 55 55 55 55 56 55 55 55 55 55 57 55 55 55 55 55 56 56
56 56 55 55 55 55 55 55 55 55 55 55 55 55 56 55 55 57 55 55 55 55 55 55 55 55 55 55 56 55 55 55 55 55 55 55 55 55 55 55 56 56
56 56 55 55 55 55 55 55 55 55 55 55 55 55 56 55 55 55 55 55 55 55 55 55 55 57 55 55 56 55 55 55 55 55 55 55 55 55 55 55 56 56
56 56 55 55 55 55 55 55 55 55 55 55 55 55 56 55 55 55 55 55 55 55 55 55 55 55 55 55 56 55 55 55 55 55 55 55 55 55 55 55 56 56
56 56 55 55 55 55 55 55 55 55 55 55 55 55 56 55 55 55 55 55 55 55 55 55 55 55 55 55 56 55 55 55 55 55 55 55 55 55 55 55 56 56
56 56 56 56 55 55 55 55 56 56 56 56 56 56 56 56 56 56 56 56 56 56 56 56 56 56 56 56 56 56 56 56 56 56 56 56 56 56 56 56 56 56
56 56 56 56 49 49 49 49 56 56 56 56 56 56 56 56 56 56 56 56 56 56 56 56 56 56 56 56 56 56 56 56 56 56 56 56 56 56 56 56 56 56
