51 51 51 51 51 51 51 51 51 51 51 51 51 51 51 51 51 51
51 50 50 50 50 50 50 50 50 50 50 50 50 50 50 50 50 51
51 50 50 50 50 50 50 50 50 50 50 50 50 54 50 50 50 51
51 50 50 50 50 50 50 50 50 50 50 50 50 54 50 50 50 51
51 50 52 52 52 52 52 52 52 52 52 52 52 52 52 52 50 51
51 50 50 59 50 50 50 50 50 50 50 50 50 50 60 50 50 51
51 50 50 50 50 50 50 50 50 50 50 50 50 50 50 50 50 51
51 50 53 53 53 53 53 50 50 50 53 53 53 53 53 50 50 51
51 50 53 53 53 53 53 50 50 50 53 53 53 53 53 50 50 51
51 50 53 53 53 53 53 50 50 50 53 53 53 53 53 50 50 51
51 50 53 53 53 53 53 50 50 50 53 53 53 53 53 50 50 51
51 50 53 53 53 53 53 50 50 50 53 53 53 53 53 50 50 51
51 50 50 50 50 50 50 50 50 50 50 50 50 50 50 50 50 51
51 51 51 51 51 51 51 49 49 49 49 51 51 51 51 51 51 51
