46 46 46 46 46 46 46 46 46 46 46 46 46 46 46 46 46 46 46 46 46 46 46 46 46 46 46 46 46 46 46 46 46 46 46 46
46 38 38 38 38 38 38 38 38 38 38 38 38 38 38 38 38 38 38 38 38 38 38 38 38 38 38 38 38 38 38 38 38 38 38 46
46 38 47 47 47 47 47 47 47 47 47 47 47 47 47 47 47 47 47 47 47 47 47 47 47 47 47 47 47 47 47 47 47 47 38 46
46 38 47 44 47 47 47 47 47 47 47 47 47 47 47 47 47 47 47 47 47 47 47 47 47 47 47 47 47 47 47 47 44 47 38 46
46 38 47 47 47 47 47 47 47 47 47 47 47 47 47 47 47 47 47 47 47 47 47 47 47 47 47 47 47 47 47 47 47 47 38 46
46 38 47 47 48 48 48 48 48 48 48 47 47 47 47 47 47 47 47 47 47 47 47 47 48 48 48 48 48 48 48 47 47 47 38 46
46 38 47 47 48 47 47 47 47 47 48 47 47 47 47 47 47 47 47 47 47 47 47 47 48 47 47 47 47 47 48 47 47 47 38 46
46 38 47 47 48 47 47 47 47 47 48 47 47 47 47 47 47 47 47 47 47 47 47 47 48 47 47 47 47 47 48 47 47 47 38 46
46 38 47 47 48 47 47 47 47 47 48 47 47 47 47 47 47 47 47 47 47 47 47 47 48 47 47 47 47 47 48 47 47 47 38 46
46 38 47 47 48 47 47 47 47 47 48 47 47 47 60 47 47 47 47 47 47 47 47 47 48 47 47 47 47 47 48 47 47 47 38 46
46 38 47 47 48 47 47 47 47 47 48 47 47 47 47 47 47 47 47 47 47 47 47 47 48 47 47 47 47 47 48 47 47 47 38 46
46 38 47 47 48 47 47 47 47 47 48 47 47 47 47 47 47 47 47 47 47 47 47 60 48 47 47 47 47 47 48 47 47 47 38 46
46 38 47 47 48 48 48 49 48 48 48 41 41 41 41 41 41 41 41 41 41 41 41 41 48 48 48 49 48 48 48 47 47 47 38 46
46 38 47 47 47 47 47 47 41 41 41 41 41 41 41 41 41 41 41 41 41 41 41 41 41 41 41 41 47 59 47 47 47 47 38 46
46 38 47 47 47 47 47 47 41 41 41 41 41 41 41 41 41 41 41 41 41 41 41 41 41 41 41 41 47 47 47 47 47 47 38 46
46 38 47 47 47 47 47 59 41 41 41 41 41 41 41 41 41 41 41 41 41 41 41 41 41 41 41 41 47 47 47 47 47 47 38 46
46 38 47 47 47 47 47 47 41 41 41 41 60 41 41 41 41 41 41 41 41 41 41 41 41 41 41 41 47 47 47 47 47 47 38 46
46 38 47 47 47 47 47 47 41 41 41 41 41 41 41 41 41 41 41 41 41 41 41 41 41 41 41 41 47 47 47 47 47 47 38 46
46 38 47 47 47 47 47 47 47 47 47 47 47 47 47 41 41 41 41 41 41 47 47 47 47 47 47 47 47 47 47 47 47 47 38 46
46 38 47 47 47 48 48 48 48 48 48 47 47 47 60 41 41 41 41 41 41 47 47 47 47 47 48 48 48 48 48 47 47 47 38 46
46 38 47 47 47 48 47 47 47 47 48 47 47 47 47 41 41 41 41 41 41 47 47 47 47 47 48 47 47 47 48 47 47 47 38 46
46 38 47 47 47 48 47 47 47 47 48 47 47 47 47 41 41 41 41 41 41 47 47 47 47 47 48 47 47 47 48 47 47 47 38 46
46 38 47 47 47 48 47 47 47 47 48 47 47 47 47 41 60 41 41 41 41 47 47 47 47 47 48 47 47 47 48 47 47 47 38 46
46 38 47 47 47 48 47 47 47 47 48 47 47 47 47 41 41 41 59 41 41 47 47 47 47 47 48 48 48 48 48 47 47 47 38 46
46 38 47 47 47 48 48 48 48 60 48 47 47 47 47 41 41 41 41 41 41 47 47 47 47 60 47 47 47 47 47 47 47 47 38 46
46 38 47 47 47 47 47 47 47 47 47 47 47 47 47 41 41 41 41 41 41 47 47 47 47 47 47 47 47 47 47 47 47 47 38 46
46 38 47 44 47 47 47 47 47 47 47 47 47 47 47 41 41 41 41 41 41 47 47 47 47 47 47 47 47 47 47 47 44 47 38 46
46 38 47 47 47 47 47 47 47 47 47 47 47 47 47 41 41 41 41 41 41 47 47 47 47 47 47 47 47 47 47 47 47 47 38 46
46 38 38 38 38 38 38 38 38 38 38 38 38 38 38 38 38 38 38 38 38 38 38 38 38 38 38 38 38 38 38 38 38 38 38 46
46 46 46 46 46 46 46 46 46 46 46 46 46 46 46 41 41 41 41 41 41 46 46 46 46 46 46 46 46 46 46 46 46 46 46 46
