61 61 61 61 61 61 61 61 61 61 61 61 61 61 61 61 61 61 61 61 61 61 61 61 61 61 61 61 61 61 61 61 61 61 61 61 61 61 61 61 61 61 61 61 61 61 61 61 61 61 61 61 61 61 61 61 61 61 61 61
61 61 61 61 61 61 61 61 61 61 61 61 61 61 61 61 61 61 61 61 61 61 61 61 61 61 61 61 61 61 61 61 61 61 61 61 61 61 61 61 61 61 61 61 61 61 61 61 61 61 61 61 61 61 61 61 61 61 61 61
61 61 61 61 61 61 61 61 61 61 61 61 61 61 61 61 61 61 61 61 61 61 61 61 61 61 61 61 61 61 61 61 61 61 61 61 61 61 61 61 61 61 61 61 61 61 61 61 61 61 61 61 61 61 61 61 61 61 61 61
61 61 61 38 38 38 38 38 38 38 38 38 38 38 38 38 38 38 38 38 38 38 38 38 38 38 38 38 38 38 38 38 38 38 38 38 38 38 38 38 38 38 38 38 38 38 38 38 38 38 38 38 38 38 38 38 38 61 61 61
61 61 61 38 38 38 38 38 38 38 38 38 38 38 38 38 38 38 38 38 38 38 38 38 38 38 38 38 38 38 38 38 38 38 38 38 38 38 38 38 38 38 38 38 38 38 38 38 38 38 56 56 56 56 56 56 56 56 61 61
61 61 61 38 38 38 38 38 38 38 38 38 38 38 38 38 38 38 38 38 38 38 46 46 46 46 46 46 46 46 38 38 38 46 46 46 46 46 46 46 46 38 38 38 38 38 38 38 38 38 56 38 38 38 38 38 38 56 61 61
61 61 61 38 38 38 38 38 38 38 38 38 38 38 38 38 38 38 38 38 38 38 38 38 38 38 38 38 38 38 41 41 41 38 38 38 38 38 38 38 38 38 38 38 38 38 38 38 38 38 56 38 55 55 55 55 38 56 61 61
61 61 61 38 38 38 38 38 38 38 38 38 38 38 38 38 38 38 38 38 38 38 38 38 38 38 38 38 38 38 41 41 41 38 38 38 38 38 38 38 38 38 38 38 44 38 38 38 38 38 56 38 55 55 55 55 38 56 61 61
61 61 61 38 38 38 38 38 44 38 38 38 38 38 38 38 38 38 38 38 38 38 38 38 38 38 38 38 38 60 41 41 41 60 38 38 38 38 38 38 38 38 38 38 38 38 38 38 38 38 56 38 55 55 55 55 38 56 61 61
61 61 61 38 38 38 38 38 38 38 38 38 38 38 38 38 38 38 38 38 38 38 38 38 38 38 38 38 38 38 41 41 41 41 41 41 41 41 41 41 41 41 41 41 41 41 41 41 41 41 56 38 55 55 55 55 38 56 61 61
61 61 61 38 38 38 38 38 38 38 38 38 38 38 38 38 38 38 38 38 38 38 38 38 38 38 38 38 38 38 41 41 41 41 41 41 41 41 41 41 41 41 41 41 41 41 41 41 41 41 56 38 55 55 55 55 38 56 61 61
61 61 61 38 38 38 38 38 38 38 38 38 38 38 38 38 38 38 38 38 38 38 38 38 38 38 38 38 38 38 41 41 41 41 41 41 41 41 41 41 41 41 41 41 41 41 41 41 41 41 56 38 38 38 38 38 38 56 61 61
61 61 61 38 38 38 38 38 38 38 38 38 38 38 44 38 38 38 38 38 38 38 38 38 38 38 45 38 38 38 41 41 41 38 38 38 38 38 38 38 38 38 38 38 38 38 38 38 38 38 56 56 56 49 49 56 56 56 61 61
61 61 61 38 38 38 38 38 38 38 38 38 38 38 38 38 38 38 38 38 38 38 38 38 38 38 38 38 38 38 41 41 41 38 38 38 38 38 38 38 38 38 38 38 38 38 38 38 38 38 38 38 38 38 38 38 38 61 61 61
61 61 61 38 38 38 38 38 38 38 38 38 38 38 38 38 38 38 38 38 38 38 38 38 38 38 38 38 38 38 41 41 41 38 38 38 38 38 38 38 38 38 38 38 38 38 38 38 38 38 38 38 38 38 38 38 38 61 61 61
61 61 61 38 38 38 38 38 44 38 38 38 38 38 38 38 38 38 38 38 38 38 38 38 38 38 38 38 38 38 41 41 41 38 38 38 38 38 38 38 38 38 38 38 38 38 38 38 38 38 38 38 38 38 38 38 38 61 61 61
61 61 61 38 38 38 38 38 38 38 38 38 38 38 38 38 38 38 38 38 38 38 38 38 38 38 38 38 38 38 41 41 41 38 38 38 38 38 38 44 38 38 38 38 38 38 38 38 38 38 38 38 38 38 38 38 38 61 61 61
61 61 61 38 38 38 38 38 38 38 38 38 38 38 38 38 38 38 38 38 38 38 38 38 45 38 38 38 38 38 41 41 41 38 38 38 38 38 38 38 38 38 38 38 38 38 38 38 38 38 38 38 38 38 38 38 38 61 61 61
61 61 61 38 38 38 38 38 38 38 45 38 38 38 38 38 38 38 38 38 38 38 38 38 38 38 38 38 38 38 41 41 41 38 38 38 38 38 38 38 38 38 38 38 38 38 38 38 38 38 38 38 38 38 38 38 38 61 61 61
61 61 61 38 38 38 38 38 38 38 38 38 38 38 38 38 38 38 38 38 38 38 38 38 38 38 38 38 38 38 41 41 41 38 38 38 38 38 38 38 38 38 38 38 38 38 38 38 38 38 38 38 38 38 38 38 38 61 61 61
61 61 61 38 38 38 38 38 38 38 38 38 38 38 38 38 38 38 44 38 38 38 38 38 38 38 38 38 38 38 41 41 41 38 38 38 38 38 38 38 38 38 38 38 38 38 38 38 38 38 38 38 38 45 38 38 38 61 61 61
61 61 61 38 38 38 38 38 38 38 38 38 38 38 38 38 38 38 38 38 38 38 38 38 38 38 38 38 38 38 41 41 41 38 38 38 38 38 38 38 38 38 38 38 38 38 38 38 38 38 38 38 38 38 38 38 38 61 61 61
61 61 61 38 38 38 38 38 38 38 38 38 45 38 38 38 38 38 38 38 38 38 38 38 38 38 38 38 38 38 41 41 41 38 38 38 38 38 38 38 38 38 38 38 38 38 38 38 38 38 38 38 38 38 38 38 38 61 61 61
61 61 61 38 38 38 38 38 38 38 38 38 38 38 38 38 38 38 38 38 38 38 38 38 38 38 38 38 38 38 41 41 41 38 38 38 38 38 38 38 38 38 38 38 38 38 38 38 38 38 38 38 38 38 38 38 38 61 61 61
61 42 42 42 42 42 42 42 42 42 38 38 38 38 38 38 38 38 38 38 38 38 38 38 38 38 38 38 38 38 41 41 41 38 38 38 38 38 38 38 38 38 38 38 38 38 38 38 44 38 41 41 41 41 41 41 41 41 61 61
61 42 42 42 42 42 42 42 42 42 38 38 38 38 38 38 38 38 38 38 38 38 38 38 38 38 38 38 38 38 41 41 41 38 38 38 38 38 38 38 41 41 41 41 41 41 41 41 41 41 41 41 41 41 41 41 41 41 61 61
61 42 42 42 42 42 42 42 42 42 38 38 38 38 38 38 38 38 39 38 38 38 38 38 38 38 38 38 38 38 41 41 41 41 41 41 41 41 41 41 41 41 41 41 41 41 41 41 41 41 41 41 41 41 41 44 41 41 61 61
61 42 42 42 42 42 42 42 42 42 38 38 38 38 38 38 38 38 59 38 41 41 41 41 41 41 41 41 41 41 41 41 41 41 41 41 41 41 41 41 41 41 41 41 41 41 41 41 41 41 38 38 38 38 38 38 38 61 61 61
61 42 42 42 42 42 42 42 58 58 41 41 41 41 41 41 41 41 41 41 41 41 41 41 41 41 41 41 41 41 41 41 41 41 41 41 41 41 41 41 38 38 38 38 38 45 38 38 38 38 38 38 38 38 38 38 38 61 61 61
61 42 41 41 41 41 41 41 41 41 41 41 41 41 41 41 41 41 41 41 41 41 41 41 41 41 41 41 41 41 41 41 41 38 38 38 38 38 38 38 38 38 38 38 38 38 38 38 38 38 38 38 38 38 38 38 38 61 61 61
61 42 41 41 41 41 41 41 41 41 41 41 41 41 41 41 41 41 41 41 38 38 38 38 38 38 38 38 38 38 41 41 41 38 38 38 38 38 38 38 38 38 38 38 38 38 38 38 38 38 38 38 38 38 38 38 38 61 61 61
61 42 41 41 41 41 41 41 41 41 58 58 58 38 38 38 38 38 38 38 38 38 38 38 38 38 38 38 38 38 38 38 38 38 38 38 38 38 38 38 38 38 38 38 38 38 38 38 38 38 38 38 38 38 38 38 38 61 61 61
61 42 42 42 42 42 42 42 42 42 38 38 38 38 38 38 38 38 38 38 44 38 38 38 38 38 38 38 38 38 38 38 38 38 38 38 38 38 38 38 38 38 38 38 38 38 38 38 38 38 38 38 38 38 38 38 38 61 61 61
61 42 42 42 42 42 42 42 42 42 38 38 38 38 38 38 38 38 38 38 38 38 38 38 38 38 38 38 38 38 38 38 38 38 38 38 38 38 38 38 38 38 38 38 38 38 38 38 38 38 38 38 38 38 38 38 38 61 61 61
61 42 42 42 42 42 42 42 42 42 38 38 38 38 38 38 38 38 38 38 38 38 38 38 38 38 44 38 38 38 38 38 38 38 38 38 38 38 38 38 38 38 38 38 38 38 38 38 38 38 38 38 38 38 38 38 38 61 61 61
61 42 42 42 42 42 42 42 42 42 38 38 38 38 38 38 38 38 38 38 38 38 38 38 38 38 38 38 38 38 38 38 38 38 38 38 38 45 38 38 38 38 38 38 38 38 38 38 38 38 38 38 38 38 38 38 38 61 61 61
61 42 42 42 42 42 42 42 42 42 38 38 38 38 38 38 38 38 38 38 38 38 38 38 38 38 38 38 38 38 38 38 38 38 38 38 38 38 38 38 38 38 38 38 38 38 38 38 38 38 38 38 38 38 38 38 38 61 61 61
61 61 61 61 61 61 61 61 61 61 61 61 61 61 61 61 61 61 61 61 61 61 61 61 61 61 61 61 61 61 61 61 61 61 61 61 61 61 61 61 61 61 61 61 61 61 61 61 61 61 61 61 61 61 61 61 61 61 61 61
61 61 61 61 61 61 61 61 61 61 61 61 61 61 61 61 61 61 61 61 61 61 61 61 61 61 61 61 61 61 61 61 61 61 61 61 61 61 61 61 61 61 61 61 61 61 61 61 61 61 61 61 61 61 61 61 61 61 61 61
61 61 61 61 61 61 61 61 61 61 61 61 61 61 61 61 61 61 61 61 61 61 61 61 61 61 61 61 61 61 61 61 61 61 61 61 61 61 61 61 61 61 61 61 61 61 61 61 61 61 61 61 61 61 61 61 61 61 61 61
