18 18 18 18 18 18 18 18 18 18 18 18 18 18 18 18 18 18 18 18 18 18 18 18 18 18 18 18 18 18 18 18 18 18 18 18 18 18 18 18 18 18 18 18 18 18 18 18 18 18 
18 18 18 18 18 18 18 18 18 18 18 18 18 18 18 18 18 18 18 18 18 18 18 18 18 18 18 18 18 18 18 18 18 18 18 18 18 18 18 18 18 18 18 18 18 18 18 18 18 18 
18 18 18 18 18 18 18 18 18 18 18 18 18 18 18 18 18 18 18 18 18 18 18 18 18 18 18 18 18 18 18 18 18 18 18 18 18 18 18 18 18 18 18 18 18 18 18 18 18 18 
18 18 18 18 18 18 18 18 18 18 18 18 18 18 18 18 18 18 18 18 18 18 18 18 18 18 18 18 18 18 18 18 18 18 18 18 18 18 18 18 18 18 18 18 18 18 18 18 18 18 
18 18 18 18 18 18 18 18 18 18 18 18 18 18 18 18 18 18 18 18 18 18 18 18 18 18 18 18 18 18 18 18 18 18 18 18 18 18 18 18 18 18 18 18 18 18 18 18 18 18 
18 18 18 18 18 18 18 18 18 18 18 18 18 18 18 18 18 18 18 18 18 18 18 18 18 18 18 18 18 18 18 18 18 18 18 18 18 18 18 18 18 18 18 18 18 18 18 18 18 18 
18 18 18 18 18 18 18 18 18 19 18 18 18 18 18 18 18 19 18 18 18 19 18 18 18 18 18 18 18 18 19 18 18 18 18 18 18 18 19 18 18 18 18 18 18 18 18 18 18 18 
18 18 19 28 26 26 26 26 26 26 26 26 26 26 26 26 26 26 26 26 26 26 26 26 26 26 26 26 26 26 26 26 26 26 26 26 26 26 26 26 26 26 26 26 29 18 18 18 18 18 
18 18 18 24 2 1 16 16 16 16 16 16 16 16 16 16 16 16 16 16 16 16 16 16 16 16 16 16 16 16 16 16 16 16 16 16 16 16 16 16 16 16 16 16 23 18 18 18 18 18 
18 18 18 24 1 1 16 16 32 32 32 32 32 32 32 32 32 32 32 32 32 32 32 32 32 32 32 32 32 32 32 32 32 32 32 32 32 32 32 32 32 32 16 16 23 18 18 19 18 18 
18 18 19 24 1 1 1 16 32 4 5 5 5 5 5 5 5 5 5 5 5 5 5 5 5 5 5 5 5 5 5 5 5 5 5 5 5 5 5 5 6 32 16 1 23 18 18 18 18 18 
18 18 18 24 2 1 1 16 32 7 1 1 1 1 1 1 1 1 1 1 1 1 1 1 1 1 1 1 1 1 1 1 1 2 16 16 16 1 1 1 8 32 16 1 23 18 18 18 18 18 
18 18 18 24 1 1 1 16 32 7 1 1 1 1 1 1 1 2 1 1 1 2 1 1 1 1 2 1 1 1 1 1 1 1 1 16 16 1 1 1 8 32 16 16 23 19 18 18 18 18 
18 18 18 24 1 1 1 16 32 7 1 1 1 12 34 34 13 1 1 2 1 1 1 1 2 1 1 1 1 12 34 34 13 1 1 1 1 1 1 1 8 32 16 1 23 18 18 18 18 18 
18 19 18 24 1 1 1 16 32 7 1 1 12 11 3 3 9 10 10 10 10 10 10 10 10 10 10 10 10 11 3 3 9 10 10 10 10 10 13 1 8 32 16 16 23 19 18 18 18 18 
18 18 18 24 1 2 1 16 32 7 1 1 8 3 3 3 3 3 3 3 3 3 3 3 3 3 3 3 3 3 3 3 3 3 3 3 3 3 34 1 8 32 16 16 23 18 18 18 18 18 
18 18 18 24 1 1 1 16 32 7 1 1 8 3 3 3 3 3 3 3 3 3 3 3 3 3 3 3 3 3 3 3 3 3 3 3 3 3 34 1 8 32 16 1 23 18 19 18 18 18 
18 18 18 24 1 1 1 16 32 7 1 1 1 5 5 5 5 5 5 5 5 5 5 5 5 6 3 3 4 5 5 5 5 5 5 5 5 5 15 1 8 32 16 16 23 18 18 18 18 18 
18 18 19 24 1 1 1 16 32 7 1 16 1 1 1 1 1 1 1 2 1 1 1 1 1 8 3 3 7 1 1 1 1 1 1 1 1 1 1 1 8 32 16 16 23 18 18 18 18 18 
18 18 18 24 1 1 1 16 32 7 16 16 1 1 1 1 2 1 1 1 1 1 1 1 1 8 3 3 7 1 1 2 2 1 1 1 2 1 1 1 8 32 16 16 23 18 18 18 18 18 
18 18 18 24 1 2 16 16 32 7 16 1 1 2 1 1 1 1 1 1 1 1 1 2 1 8 3 3 7 1 1 1 1 1 1 1 1 2 1 1 8 32 16 1 23 19 18 18 18 18 
18 18 18 24 1 1 32 32 32 9 10 10 10 10 10 10 10 10 10 10 10 10 10 10 10 11 3 3 7 1 1 2 1 1 1 1 1 1 1 1 8 32 16 1 23 18 18 18 18 18 
18 18 18 34 34 34 3 3 3 3 3 3 3 3 3 3 3 3 3 3 3 3 3 3 3 3 3 3 7 1 1 1 1 16 16 1 1 1 1 1 8 32 16 1 23 18 18 18 18 18 
19 18 18 34 34 34 3 3 3 3 3 3 3 3 3 3 3 3 3 3 3 3 3 3 3 3 3 3 7 1 1 16 16 16 16 1 1 1 1 1 8 32 16 1 23 18 18 19 18 18 
18 18 18 24 1 1 32 32 32 4 5 5 5 5 5 5 5 5 5 5 5 5 5 5 5 6 3 3 7 1 16 16 16 16 1 1 1 1 1 1 8 32 16 16 23 18 18 18 18 18 
18 18 18 24 1 1 16 16 32 7 2 1 1 1 1 1 1 1 1 1 1 1 1 1 1 8 3 3 7 1 16 16 16 16 1 1 12 10 10 10 11 32 16 1 23 18 19 18 18 18 
18 18 18 24 1 1 1 16 32 7 1 2 1 1 1 1 1 1 1 1 1 1 2 1 1 8 3 3 7 1 1 16 16 1 1 1 8 34 34 34 34 32 16 1 23 18 18 18 18 18 
18 18 18 24 1 2 1 16 32 7 1 1 1 1 2 1 1 1 2 1 1 1 1 1 2 8 3 3 7 1 2 1 1 1 1 1 8 34 34 34 34 32 16 16 23 18 18 18 18 18 
18 18 19 24 2 1 1 16 32 7 1 1 1 16 1 16 16 1 1 1 1 1 1 1 1 8 3 3 7 1 1 1 1 1 1 1 8 34 34 34 34 32 16 16 23 18 18 18 18 18 
18 18 18 24 1 1 1 16 32 7 1 2 1 16 16 16 16 1 1 1 2 1 1 1 1 8 3 3 9 10 10 10 10 10 10 10 11 34 34 34 34 32 16 16 23 18 18 18 18 18 
18 18 18 24 1 1 1 16 32 7 1 1 1 16 16 16 1 1 1 1 1 1 1 1 12 11 3 3 3 3 3 3 3 3 3 3 3 34 34 34 34 32 16 16 23 19 18 18 18 18 
18 18 18 24 2 1 1 16 32 7 1 1 1 16 16 16 16 1 1 1 1 1 1 12 11 3 3 3 3 3 3 3 3 3 3 3 3 34 34 34 34 32 16 16 23 18 18 18 18 18 
18 18 18 24 1 2 1 16 32 7 1 1 2 16 16 16 16 16 1 1 1 1 12 11 3 3 3 4 5 5 5 5 5 5 5 5 6 34 34 34 34 32 16 1 23 18 18 18 18 18 
18 18 18 24 1 1 1 16 32 7 1 1 1 1 1 1 1 1 1 1 1 12 11 3 3 3 4 15 1 1 1 1 1 1 1 1 8 34 34 34 34 32 16 1 23 18 18 18 18 18 
18 19 18 24 1 2 1 16 32 7 1 1 1 2 12 10 10 10 10 10 10 11 3 3 3 4 15 2 1 1 1 1 1 1 1 1 8 34 34 34 34 32 16 16 23 18 19 18 18 18 
18 18 18 24 1 1 1 16 32 7 1 1 1 1 34 3 3 3 3 3 3 3 3 3 4 15 1 1 1 1 1 2 1 1 1 1 8 34 34 34 34 32 16 1 23 18 18 18 18 18 
18 18 18 24 1 1 2 16 32 7 1 1 1 1 34 3 3 3 3 3 3 3 3 4 15 1 1 1 1 16 16 16 16 16 1 1 14 5 5 5 6 32 16 16 23 18 18 18 18 18 
18 18 18 24 1 1 1 16 32 7 1 1 1 1 14 5 5 5 5 5 5 5 5 15 1 1 1 1 16 16 16 16 16 16 1 1 1 1 1 1 8 32 16 1 23 19 18 18 18 18 
18 18 18 24 2 1 1 16 32 7 1 1 1 1 1 1 1 2 1 1 1 1 1 1 1 1 2 1 16 16 16 16 16 2 1 1 1 1 1 1 8 32 16 1 23 18 18 18 18 18 
18 18 18 24 1 1 1 16 32 7 2 1 16 1 16 16 16 1 1 1 1 1 1 1 1 1 1 1 16 16 1 1 1 1 1 1 1 1 1 1 8 32 16 16 23 18 18 19 18 18 
18 18 19 24 1 2 1 16 32 7 1 1 16 16 16 16 2 1 1 1 1 1 1 1 1 1 1 1 2 1 1 1 1 1 1 1 1 1 1 1 8 32 16 16 23 18 18 18 18 18 
18 18 18 24 1 1 1 16 32 9 10 10 10 10 10 10 10 10 10 10 10 10 10 10 10 10 10 10 10 10 10 10 10 10 10 10 10 10 10 10 11 32 16 1 23 18 18 18 18 18 
18 18 18 24 1 1 16 16 32 32 32 32 32 32 32 32 32 32 32 32 32 32 32 32 32 32 32 32 32 32 32 32 32 32 32 32 32 32 32 32 32 32 16 16 23 18 19 18 18 18 
18 18 18 24 1 16 16 16 16 16 16 16 16 16 16 16 16 16 16 16 16 16 16 16 16 16 16 16 16 16 16 16 16 16 16 16 16 16 16 16 16 16 16 16 23 18 18 18 18 18 
18 19 18 30 21 21 21 21 21 21 21 21 21 21 21 21 21 21 21 21 21 21 21 21 21 21 21 21 21 21 21 21 21 21 21 21 21 21 21 21 21 21 21 21 31 19 18 18 18 18 
18 18 18 18 19 18 18 18 18 18 18 18 18 18 19 18 18 18 18 18 18 19 18 18 18 18 18 19 18 18 18 18 18 18 18 18 18 18 19 18 18 18 18 18 18 18 18 18 18 18 
18 18 18 18 18 18 18 18 18 18 18 18 18 18 18 18 18 18 18 18 18 18 18 18 18 18 18 18 18 18 18 18 18 18 18 18 18 18 18 18 18 18 18 18 18 18 18 18 18 18 
18 18 18 18 18 18 18 18 18 18 18 18 18 18 18 18 18 18 18 18 18 18 18 18 18 18 18 18 18 18 18 18 18 18 18 18 18 18 18 18 18 18 18 18 18 18 18 18 18 18 
18 18 18 18 18 18 18 18 18 18 18 18 18 18 18 18 18 18 18 18 18 18 18 18 18 18 18 18 18 18 18 18 18 18 18 18 18 18 18 18 18 18 18 18 18 18 18 18 18 18 
18 18 18 18 18 18 18 18 18 18 18 18 18 18 18 18 18 18 18 18 18 18 18 18 18 18 18 18 18 18 18 18 18 18 18 18 18 18 18 18 18 18 18 18 18 18 18 18 18 18 
